1111111111
1P00000001
1011111101
100CCC0101
1010110101
10100001E1
1111111111