111111111111111111111111
100100C0000010C000011111
1000000000C000C011111001
1P0000001010000000000001
100C00111100000111000001
10000000C0000000C0000E01
111111111111111111111111