1111111111
100P000001
1011111101
100CCC0101
10101101X1
10100000E1
1111111111