111111111111111111111111
100C00C0000010C000000001
1111111000C000C011111001
1P00000001110000000000E1
100C00111100000111000001
1000000C0000000C0000X001
111111111111111111111111