111111111111111111111111
100C00C0000010C000000001
1111011000C000C011111101
1P0100100111000000000101
100C000110000011100001X1
1000000C0011100C00000CE1
111111111111111111111111